000000000010000
010011111100000
010110000000000
011100000000000
000010001111100
011100000000100
011000000000000
011000010101011
000010000000000
011000100000000
011001100001000
011000111111000
011000000001000
001000000000100
001000000000100